w 27
h 27

m 8, 5, 5, 5, 5, 5, 5, 5, 5, 5, 5, 5, 5, 5, 5, 5, 5, 5, 5, 5, 5, 5, 5, 5, 5, 5, 8
m 5, 7, 1, 1, 7, 1, 1, 7, 1, 1, 7, 1, 1, 7, 1, 1, 7, 1, 1, 7, 1, 1, 7, 1, 1, 1, 5
m 5, 1, 1, 1, 1, 1, 1, 1, 1, 1, 1, 1, 1, 1, 1, 1, 1, 1, 1, 1, 1, 1, 1, 1, 1, 1, 5
m 5, 7, 1, 1, 7, 1, 1, 7, 1, 1, 7, 1, 1, 7, 1, 1, 7, 1, 1, 7, 1, 1, 7, 1, 1, 1, 5
m 5, 1, 1, 1, 1, 1, 1, 1, 1, 1, 1, 1, 1, 1, 1, 1, 1, 1, 1, 1, 1, 1, 1, 1, 1, 1, 5
m 5, 7, 1, 1, 7, 1, 5, 5, 1, 1, 7, 1, 1, 7, 1, 1, 7, 1, 1, 7, 1, 1, 7, 1, 1, 1, 5
m 5, 1, 1, 1, 1, 1, 5, 1, 1, 1, 1, 1, 1, 1, 1, 1, 1, 1, 1, 1, 1, 1, 1, 1, 1, 1, 5
m 5, 7, 1, 1, 7, 1, 5, 7, 1, 1, 7, 1, 1, 7, 1, 1, 7, 1, 1, 7, 1, 1, 7, 1, 1, 1, 5
m 5, 1, 1, 1, 1, 1, 5, 5, 1, 1, 1, 1, 1, 1, 1, 1, 1, 1, 1, 1, 1, 1, 1, 1, 1, 1, 5
m 5, 7, 1, 1, 7, 1, 5, 7, 1, 1, 7, 1, 1, 7, 1, 1, 7, 1, 1, 7, 1, 1, 7, 1, 1, 1, 5
m 5, 1, 1, 1, 1, 1, 1, 1, 1, 1, 1, 1, 1, 1, 1, 1, 1, 1, 1, 1, 1, 1, 1, 1, 1, 1, 5
m 5, 7, 1, 1, 7, 1, 1, 7, 1, 1, 7, 1, 1, 7, 1, 1, 7, 1, 1, 7, 1, 1, 7, 1, 1, 1, 5
m 5, 1, 1, 1, 1, 1, 1, 1, 1, 1, 1, 1, 4, 1, 1, 1, 1, 1, 1, 1, 1, 1, 1, 1, 1, 1, 5
m 5, 7, 1, 1, 7, 1, 1, 7, 1, 1, 7, 1, 1, 7, 1, 1, 7, 1, 1, 7, 1, 1, 7, 1, 1, 1, 5
m 5, 1, 1, 1, 1, 1, 1, 1, 1, 1, 1, 1, 1, 1, 1, 1, 1, 1, 1, 1, 1, 1, 1, 1, 1, 1, 5
m 5, 7, 1, 1, 7, 1, 1, 7, 1, 1, 7, 1, 1, 7, 1, 1, 7, 1, 1, 7, 1, 1, 7, 1, 1, 1, 5
m 5, 1, 1, 1, 1, 1, 1, 1, 1, 1, 1, 1, 1, 1, 1, 1, 1, 1, 1, 1, 1, 1, 1, 1, 1, 1, 5
m 5, 7, 1, 1, 7, 1, 1, 7, 1, 1, 7, 1, 1, 7, 1, 1, 7, 1, 1, 7, 1, 1, 7, 1, 1, 1, 5
m 5, 1, 1, 1, 1, 1, 1, 1, 1, 1, 1, 1, 1, 1, 1, 1, 1, 1, 1, 1, 1, 1, 1, 1, 1, 1, 5
m 5, 7, 1, 1, 7, 1, 1, 7, 1, 1, 7, 1, 1, 7, 1, 1, 7, 1, 1, 7, 1, 1, 7, 1, 1, 1, 5
m 5, 1, 1, 1, 1, 1, 1, 1, 1, 1, 1, 1, 1, 1, 1, 1, 1, 1, 1, 1, 1, 1, 1, 1, 1, 1, 5
m 5, 7, 1, 1, 7, 1, 1, 7, 1, 1, 7, 1, 1, 7, 1, 1, 7, 1, 1, 7, 1, 1, 7, 1, 1, 1, 5
m 5, 1, 1, 1, 1, 1, 1, 1, 1, 1, 1, 1, 1, 1, 1, 1, 1, 1, 1, 1, 1, 1, 1, 1, 1, 1, 5
m 5, 7, 1, 1, 7, 1, 1, 7, 1, 1, 7, 1, 1, 7, 1, 1, 7, 1, 1, 7, 1, 1, 7, 1, 1, 1, 5
m 5, 1, 1, 1, 1, 1, 1, 1, 1, 1, 1, 1, 1, 1, 1, 1, 1, 1, 1, 1, 1, 1, 1, 1, 1, 1, 5
m 5, 1, 1, 1, 1, 1, 1, 1, 1, 1, 1, 1, 1, 1, 1, 1, 1, 1, 1, 1, 1, 1, 1, 1, 1, 1, 5
m 8, 5, 5, 5, 5, 5, 5, 5, 5, 5, 5, 5, 5, 5, 5, 5, 5, 5, 5, 5, 5, 5, 5, 5, 5, 5, 8
